NO ./path_to_the_north_texture
SO ./path_to_the_south_texture
WE ./path_to_the_west_texture
EA ./path_to_the_east_texture

F 255,0,0
C 0,0,255

1111111
1000001
1000W01
1000001
1111111