NO ./textures/n.xpm
SO ./textures/s.xpm
WE ./textures/w.xpm
EA ./textures/e.xpm

F 220,180,120
C 120,180,255

1111111111111111111
1N0D00010000D000011
1110D11101110D11111
1D0001D0001D0000D11
1011101111011101011
1D000D000D000D00011
1110111011101110111
1D0001D0001D0000D11
1011101111011101011
1D000D000D000D00011
1111111111111111111