NO ./textures/n.xpm
SO ./textures/s.xpm
WE ./textures/w.xpm
EA ./textures/e.xpm
F 255, 140, 60
C 60, 120, 255

1111111111111111111111111111111
1E00000000001100000000000000001
1110111111011101111111011111101
1000100001000001000000010000001
1011101111111110111111011111101
1000001000000010000000010000001
1011111011111011111111110111101
1000000010000001000000000000001
1111111010111111010111111111101
1000000010000000010000000000001
1011111111111011111011111011101
1000000000001000000000010000001
1011111111101111111111111111101
1000000000000000000000000000001
1111111011111111111111011111111
1000000010000000000000010000001
1011111110111111111111010111111
1000000000000000000000000000001
1111111111111111111111111111111